1111111111111
10010000000C1111
1000011111001011
1P0011E000001011
1111111111111