1111111111111111111111111111
100000000000011000110000E001
1001110001110000000000000001
1001000000000000000001000001
1001110000C11100000011100001
100000000001C000000000000001
1000000P00000C00011000000001
1111111111111111111111111111