11111111111111
10100100000001
10100100011001
101001010C1001
10100101111001
1P1000000000E1
100010C00000C1
11111111111111
