1111111111111
1001000C00011
1000011111011
1P0011E000011
1001000C00011
1001000C00011
1001000C00011
1001000C00011
1001000C00011
1001000C00011
1001000C00011
1001000C00011
1111111111111