1111111111111
11C10000000C1
1100011111001
1P0011E100001
1111111111111