werwer1111111111111
100100wec00000C1
1000011111001
100011E000001
1111111111111 lkjdlksajdakjdasd
aslkdjaslkjdas;D
123124&*!^#()